121,123,37,37,37,37,37,37,37,37,37,37,37,37,37,37,37,37,37,37,37,37,37,37,37,37,37,37,37,37,121,123
121,123,-1,-1,-1,-1,-1,-1,-1,-1,-1,11,-1,-1,-1,-1,-1,-1,-1,-1,-1,-1,-1,-1,-1,-1,-1,-1,37,37,121,123
121,123,-1,-1,-1,-1,-1,-1,-1,-1,-1,11,-1,-1,-1,-1,-1,-1,-1,-1,-1,-1,-1,-1,-1,-1,-1,-1,-1,-1,-1,-1
121,123,-1,-1,-1,-1,-1,-1,-1,-1,777,11,-1,-1,-1,11,-1,-1,-1,-1,-1,-1,-1,-1,-1,-1,-1,-1,-1,-1,-1,-1
121,123,-1,-1,-1,-1,-1,-1,-1,-1,-1,11,-1,-1,-1,11,-1,-1,-1,-1,-1,-1,-1,-1,-1,-1,-1,-1,-1,-1,-1,-1
121,123,-1,-1,-1,-1,-1,-1,-1,-1,-1,11,-1,-1,-1,11,-1,-1,-1,-1,-1,-1,-1,-1,-1,-1,-1,-1,-1,-1,-1,-1
121,123,-1,-1,-1,-1,-1,-1,-1,-1,-1,11,-1,-1,-1,11,-1,-1,-1,-1,-1,-1,-1,-1,-1,-1,-1,11,-1,-1,-1,-1
121,123,-1,-1,-1,-1,-1,-1,-1,-1,-1,11,-1,-1,-1,11,-1,-1,-1,-1,-1,-1,-1,-1,-1,-1,-1,11,-1,-1,-1,-1
121,123,-1,-1,-1,-1,-1,-1,-1,-1,-1,11,-1,-1,-1,11,-1,-1,-1,-1,-1,-1,-1,-1,-1,-1,-1,11,-1,-1,-1,-1
121,123,-1,-1,99,70,71,-1,-1,-1,-1,11,-1,-1,-1,11,-1,-1,-1,-1,-1,-1,-1,-1,-1,-1,-1,11,-1,-1,-1,-1
121,123,-1,-1,93,1,2,-1,-1,-1,-1,11,-1,-1,-1,11,-1,-1,-1,-1,-1,-1,-1,-1,-1,-1,-1,11,-1,-1,-1,-1
121,123,-1,-1,26,66,28,-1,-1,-1,-1,11,-1,-1,-1,11,-1,-1,-1,-1,-1,-1,-1,-1,-1,-1,-1,11,-1,-1,-1,-1
121,123,-1,-1,-1,65,-1,-1,-1,-1,-1,11,-1,-1,-1,11,-1,-1,-1,-1,-1,-1,-1,-1,-1,-1,-1,11,-1,-1,-1,-1
121,123,-1,-1,-1,116,-1,-1,-1,-1,-1,11,-1,-1,-1,11,-1,-1,-1,-1,-1,-1,-1,-1,-1,-1,-1,11,-1,-1,-1,-1
121,123,-1,-1,-1,136,-1,-1,-1,-1,-1,-1,-1,-1,-1,11,-1,-1,-1,-1,-1,-1,-1,-1,-1,-1,-1,11,111,-1,-1,-1
121,123,130,-1,125,137,128,126,-1,-1,-1,-1,127,-1,-1,11,-1,-1,-1,-1,-1,-1,-1,-1,-1,-1,-1,11,131,-1,-1,-1
121,122,75,75,75,75,75,75,75,75,75,75,75,75,75,75,-1,-1,-1,-1,-1,-1,-1,-1,-1,-1,-1,75,75,75,75,75
121,122,122,122,122,122,122,122,122,122,122,122,122,122,122,122,-1,-1,-1,-1,-1,-1,-1,-1,-1,-1,-1,122,122,122,122,123
121,122,122,122,122,122,122,122,122,122,122,122,122,122,122,122,-1,-1,-1,-1,-1,-1,-1,-1,-1,-1,-1,122,122,122,122,123
